1 1 1 1 1 1 1
1 1 1 1 1 1 1
1 1 1 1 1 1 1
1 1 1 1 1 1 1
1 1 1 1 1 1 1
1 1 1 1 1 1 1
1 1 1 1 1 1 1

1 1 1 1 1 1 1
1 1 1 1 0 0 1
1 1 1 1 0 0 1
1 1 1 1 0 0 1
1 1 1 0 5 0 1
1 0 0 0 0 0 1
1 1 1 1 1 1 1

1 1 1 1 3 3 3
1 3 3 3 0 0 3
1 3 1 1 0 0 6
3 3 1 1 0 0 1
3 1 0 0 0 0 1
3 0 0 0 0 0 1
3 3 2 1 1 1 1

1 1 1 1 1 1 1
1 0 0 0 0 0 1
1 0 0 5 0 0 1
1 0 0 0 0 0 1
1 0 0 0 0 0 1
1 0 0 0 0 0 1
1 1 1 1 1 1 1

1 1 1 1 1 1 1
1 0 0 0 0 0 1
1 0 0 0 0 0 1
1 0 0 0 0 0 1
1 0 0 0 0 0 1
1 0 0 0 0 0 1
1 1 1 1 1 1 1

1 1 1 1 1 1 1
1 0 0 0 0 0 1
1 0 0 0 0 0 1
1 0 0 0 0 0 1
1 0 0 0 0 0 1
1 0 0 0 0 0 1
1 1 1 1 1 1 1